NO ./Beer.xpm
SO ./Beer.xpm
WE ./Beer.xpm
EA ./Beer.xpm

F 220,100,0
C 225,30,0

1111111111111111111111111
1000000000110000000000001
10110000011100000000000011
100100000000000000000000111111111
111111111011000001110000000000001
100000000011000001110111111111111
111101111111110111000000100011111
11110111111111011101010010001111
11000000110101011100000010001111
10000000000000001100000000001111
1000000000000000110100000000111
11000001110101011111011110N0111
11110111 1110101 101111010001
11111111 1111111 111111111111