NO srcs/xpm/parede.xpm

SO srcs/xpm/parede.xpm

WE srcs/xpm/parede.xpm

EA srcs/xpm/parede.xpm


F 125,255,132


C 112,180,255

1111111
1000011
100N001
1001001
1000101
1111111