NO srcs/xpm/parede.xpm

SO srcs/xpm/parede.xpm

WE srcs/xpm/parede.xpm

EA srcs/xpm/parede.xpm

F 255,255,132  

C 12,180,255

111111
1000B1
100001
100001
10N001
111111