1111111111111111111111111
1000000000110000000000001
1011000001110001000000001
10010000000000010000000111111111
11111111101100P001110000000000001
1000000000110001011101111111111111111
1111111111110111111111011100000010001
1111011111111101110101001000111111111
    111110000110101011100000010001111111111
    111111110000000000000001100000010001
1111110000000000011010100100011111111111
1100111111010101111101111111111
111011111110101101111010001
11111111111111111111111111
