NO srcs/xpm/Security.xpm
SO srcs/xpm/Security.xpm
WE srcs/xpm/Security.xpm
EA srcs/xpm/Security.xpm

C 12,180,255
F 255,255,255

1111111111111111111111111
1000000000110000000000001
10110000011100000000000011
100100000000000000000000111111111
111111111011000001110000000000001
10000000001100000100111111111111
111101111111110111000010100011111
11110111111111011111000010001111
110000001101010110000N0000101111
10000000000000000000000000001111
10001001000000000000000000000111
11000001110101011101100011000111
11110111 1110101 1010010010101
11111111 1111111 111111111111