NO srcs/xpm/parede.xpm

SO srcs/xpm/parede.xpm

WE srcs/xpm/parede.xpm

EA srcs/xpm/parede.xpm

F 255,255,132    

C 12,180,255

1111111111111111111111111
100000000011000N0000000011
101100000111000000000000111111111111
1001000000000000000000000000000000001
111111111011000001110000000000001111
10000000001111111100110101111111
1111011111111101110111B11111111111
111101111111111111000000001111
1100000011111111100000000010111111
1000000000000110000000000000001111
1000100100000011100000000000011111
1100000111010101110110001100011111
11110111 1110101 1010010010101
11111111 1111111 111111111111