NO srcs/xpm/parede.xpm

SO srcs/xpm/parede.xpm

WE srcs/xpm/parede.xpm

EA srcs/xpm/parede.xpm


F 255,255,132

C 112,180,255

111111111
100000001
100010001
100000N01
111111111