NO     srcs/xpm/parede.xpm

SO  srcs/xpm/parede.xpm

WE          srcs/xpm/parede.xpm

EA              srcs/xpm/parede.xpm


F 255,255,132

C 112,180,255

11111111111111111        
1000000000110000111111111
101100000111000001      
1001000000000000011111111
1111111110110000011100001111
111111111111101100000111011111111
111101111111110111000000100000111  
111101111111110111010100100000111
110000001101010111000000100000111
100000000000000011000000100000111
100000000000000011010100000000111
11000001110101011111011110N011111
11110111 1110101 1011110100000111
11111111 1111111 1111111111111111
