NO srcs/xpm/parede.xpm

SO srcs/xpm/parede.xpm

WE srcs/xpm/parede.xpm

EA srcs/xpm/parede.xpm

F 125,255,132

C 112,180,255

1111111111111111111111111
1000001000110000100000111
101100100111000001001001
100100000000000N0000000011111111
111111111011000001110001011000001
10000000001110001110111111111111
111101111111 11011100000010001
11110111111111011101010010001111
110000001101010111000000001111
1001000100000001001000100011001
1000010000000100000101001000001
110000011101010111111111100001
1111011 111101011011011 100011
1111111 111111111111111 11111