NO     srcs/xpm/parede.xpm

SO  srcs/xpm/parede.xpm

WE          srcs/xpm/parede.xpm

EA              srcs/xpm/parede.xpm

F 255,255,132  

C 12,180,255

        1111111111111111111111111    
        1000000000110000000000001    
        1011000001110000000000001    
        1001000000000000000000001    
        1111111110110000011100001    
1111111111111011000001110111111111111
11110111111111011100000010001        
11110111111111011101010010001        
11000000110101011100000010001        
10000000000000001100000010001        
10000000000000001101010000001        
11000001110101011111011110N0111      
11110111 1110101 101111010001        
11111111 1111111 111111111111