NO srcs/xpm/parede.xpm

SO srcs/xpm/parede.xpm

WE srcs/xpm/parede.xpm

EA srcs/xpm/parede.xpm

F 255,255,132

C  12 , 180 , 255

1111111111111111111111111
1000000000110000000000001
10110000011100000000000011
100100000000000000000000111111111
111111111011000001110000000000001
10000000001111111100111111111111
111101111111110111000010111111111
1111011111111111111010010001111
110000001111111110000N00001011111
1000000000000110000000000000001111
100010010000001110000000000001111
11000001110101011101100011000111
11110111 1110101 1010010010101
11111111 1111111 111111111111