NO srcs/xpm/parede.xpm

SO srcs/xpm/parede.xpm

WE srcs/xpm/parede.xpm

EA srcs/xpm/parede.xpm


F 1255,255,132

C 112,180,255

1111111
1001011
100N001
1000101
1000101
1111111